{
  "ا": 0,
  "ب": 1,
  "پ": 2,
  "ت": 3,
  "ث": 4,
  "ج": 5,
  "چ": 6,
  "ح": 7,
  "خ": 8,
  "د": 9,
  "ذ": 10,
  "ر": 11,
  "ز": 12,
  "ژ": 13,
  "س": 14,
  "ش": 15,
  "ص": 16,
  "ض": 17,
  "ط": 18,
  "ظ": 19,
  "ع": 20,
  "غ": 21,
  "ف": 22,
  "ق": 23,
  "ک": 24,
  "گ": 25,
  "ل": 26,
  "م": 27,
  "ن": 28,
  "و": 29,
  "ه": 30,
  "ی": 31
}